Shadowsocks=Shadowsocks
Enable=启用代理
Mode=代理模式
PAC=PAC 模式
Global=全局模式
Servers=服务器选择
Edit Servers...=编辑服务器...
Start on Boot=自动启动
Share over LAN=在局域网共享代理
Edit PAC File...=编辑 PAC 文件...
Show QRCode...=显示二维码...
Show Logs...=显示日志...
About...=关于...
Quit=退出
Edit Servers=编辑服务器
&Add=添加(&A)
&Delete=删除(&D)
Server=服务器
Server IP=服务器 IP
Server Port=服务器端口
Password=密码
Encryption=加密
Proxy Port=代理端口
Remarks=备注
OK=确定
Cancel=取消
New server=新服务器
QRCode=二维码
Shadowsocks Error: {0}=Shadowsocks 错误: {0}
Port is already used=端口已被占用
Illegal port number format=非法端口格式
Please add at least one server=请添加至少一个服务器
Shadowsocks {0} Update Found=Shadowsocks {0} 更新
Click here to download=点击这里下载
Shadowsocks is here=Shadowsocks 在这里
You can turn on/off Shadowsocks in the context menu=可以在右键菜单中开关 Shadowsocks